Grapheme	IPA
^	NULL
$	NULL
a	a
a:	aː
c	tɕ
j	dʑ
ɟ	ɟ
ch	tɕʰ
cʰ	tɕʰ
e	e
ǝ	ə
ə	ə
ɛ	ɛ
ɛ:	ɛː
^h	h
i	i
ɨ	ɨ
i:	iː
ɨ́	ɨ́/ɨ
y	j
g	g
k	k
k'	k͈
kʰ	kʰ
l	l
m	m
n	n
ŋ	ŋ
b	b
p	p
p'	p͈
pʰ	pʰ
r	ɾ
s	s
s'	s͈
d	d
t	t
c'	t͈ɕ
j'	d͈ʑ
t'	t͈
th	tʰ
tʰ	tʰ
o	o
ø	ø
ɔ	ɔ
w	w
u	u
-	+
-h	+ h
^-	NULL
-$	NULL
--	+
